##############################
####                 #########
##   ###################   # #
## ####                # # # #
## ################### # # # #
##                     # # # #
###################### # # # #
##   ##                # # # #
## # ## ### ## ######### # # #
## #    #   ##B#         # # #
## # ## ################ # # #
#### ##             #### # # #
#### ############## ## # # # #
####             ##    # # # #
####### ######## ####### # # #
####### ####             #   #
#A      ######################
##############################